
        SO./path_to_the_south_texture
F        220,5,1
C  225           ,   1  ,  250


NO./path_to_the_north_texture


EA ./path_to_the_east_texture

WE ./path_to_the_west_texture

11111
10S1
1111
